4 4 4 4 4 4 4 4 4 4 4 4 4 4 4 4 1 1 1 1 1 1 1 1 1 1 1 1 1 1 1 1
4 0 0 0 0 14 0 0 0 0 0 0 0 0 0 4 1 0 0 0 0 0 0 0 0 0 0 0 0 0 0 1
4 0 0 0 0 0 0 0 0 0 0 0 0 0 0 4 1 0 0 0 0 0 0 0 0 0 0 0 0 0 0 1
4 0 0 0 0 14 0 0 0 0 0 0 0 0 0 4 1 0 0 0 0 0 0 0 0 0 0 0 0 0 0 1
4 4 0 0 0 4 0 0 0 0 0 0 0 0 0 4 1 0 0 0 0 0 0 0 0 0 0 0 0 0 0 1
4 4 15 7 15 4 4 0 0 0 0 0 0 0 0 4 1 0 0 0 0 0 0 0 0 0 0 0 0 0 0 1
4 0 0 0 0 0 0 6 0 0 0 0 0 0 0 0 0 0 0 0 0 0 0 0 0 0 0 0 0 0 0 1
4 0 0 6 0 0 0 6 0 0 0 0 0 0 0 0 0 0 0 0 0 0 0 0 0 0 0 0 0 0 0 1
4 0 0 6 0 0 0 6 0 0 0 0 0 0 0 4 1 0 0 0 0 0 0 0 0 0 0 0 0 0 0 1
4 0 0 0 0 0 0 0 0 0 0 0 0 0 0 4 1 0 0 0 0 0 0 0 0 0 0 0 0 0 0 1
4 0 0 0 0 0 0 0 0 0 0 0 0 0 0 4 1 0 0 0 0 0 0 0 0 0 0 0 0 0 0 1
4 0 0 0 0 0 0 0 0 0 0 0 0 0 0 4 1 0 0 0 0 0 0 0 0 0 0 0 0 0 0 1
4 0 0 0 0 0 0 0 0 0 0 0 0 0 0 4 1 0 0 0 0 0 0 0 0 0 0 0 0 0 0 1
4 0 0 0 0 0 0 0 0 0 0 0 0 0 0 4 1 0 0 0 0 0 0 0 0 0 0 0 0 0 0 1
4 0 0 0 0 0 0 0 0 0 0 0 0 0 0 4 1 0 0 0 0 0 0 0 0 0 0 0 0 0 0 1
4 4 4 4 4 4 0 0 4 4 4 4 4 4 4 4 1 0 0 0 0 0 0 0 0 0 0 0 0 0 0 1
2 2 2 2 2 2 0 0 2 2 2 2 2 2 2 2 1 1 1 1 1 1 0 0 0 1 1 1 1 1 1 1
2 0 0 0 0 0 0 0 0 0 0 0 0 0 0 2 6 8 8 6 6 0 0 0 0 0 0 0 0 0 0 6
2 0 0 0 0 0 0 0 0 0 0 0 0 0 0 2 6 0 0 6 6 0 0 0 0 0 0 0 0 0 0 6
2 0 0 0 0 0 0 0 0 0 0 0 0 0 0 2 6 0 0 6 6 0 0 0 0 0 0 0 0 0 0 6
2 0 0 0 0 0 0 0 0 0 0 0 0 0 0 2 6 0 0 6 6 0 0 0 0 0 0 0 0 0 0 6
2 0 0 0 0 0 0 6 6 6 6 0 0 0 0 2 6 0 0 6 6 0 0 0 0 0 0 0 0 0 0 6
2 0 0 0 0 0 0 6 0 0 0 0 0 0 0 2 6 0 0 0 0 0 0 0 0 0 0 0 0 0 0 6
2 0 0 0 0 0 0 6 0 0 0 0 0 0 0 2 6 0 0 0 0 0 0 0 0 0 0 0 0 0 0 6
2 0 0 0 0 0 0 6 6 6 6 0 0 0 0 2 6 0 0 0 0 0 0 0 0 0 0 0 0 0 0 6
2 0 0 0 0 0 0 0 0 0 6 0 0 0 0 2 6 0 0 0 0 0 0 0 0 0 0 0 0 0 0 6
2 0 0 0 0 0 0 0 0 0 6 0 0 0 0 2 6 0 0 0 0 0 0 0 0 0 0 0 0 0 0 6
2 0 0 0 0 0 0 0 0 0 6 6 6 6 6 2 6 0 0 0 0 0 0 0 0 0 0 0 0 0 0 6
2 0 0 0 0 0 0 0 0 0 0 0 0 0 0 2 6 0 0 0 0 0 0 0 0 0 0 0 0 0 0 6
2 0 0 0 0 0 0 0 0 0 0 0 0 0 0 2 6 0 0 0 0 0 0 0 0 0 0 0 0 0 0 6
2 0 0 0 0 0 0 0 0 0 0 0 0 0 0 2 6 0 0 0 0 0 0 0 0 0 0 0 0 0 0 6
2 2 2 2 2 2 2 2 2 2 2 2 2 2 2 2 6 6 6 6 6 6 6 6 6 6 6 6 6 6 6 6