6 6 6 6 6 6 6 7 6 6 6 6 6 6 6 6 7 7 7 7 7 7 7 7 7 7 7 7 7 7 7 7
6 0 0 0 0 6 0 0 0 6 0 0 0 0 6 6 0 8 8 0 0 0 0 0 0 0 0 0 0 0 0 6
6 0 0 0 0 0 0 0 0 7 0 0 0 0 6 6 0 0 0 0 6 0 0 0 0 0 0 0 0 0 0 6
6 0 0 0 0 6 0 0 0 6 0 0 0 0 6 6 0 0 0 0 6 0 0 0 0 0 0 0 0 0 0 6
6 6 6 6 6 6 0 0 0 6 6 6 6 6 6 6 0 0 0 0 6 0 0 0 0 0 0 0 0 0 0 6
6 0 0 0 0 6 0 0 0 6 0 0 0 0 6 6 0 0 0 0 6 0 0 0 0 0 0 0 0 0 0 6
6 0 0 0 0 7 0 0 0 7 0 0 0 0 6 6 0 0 0 0 0 0 0 0 0 0 0 0 0 0 0 6
6 0 0 0 0 6 0 0 0 6 0 0 0 0 6 6 0 0 0 0 0 0 0 0 0 0 0 0 0 0 0 6
6 6 6 6 6 6 0 0 0 6 6 6 6 6 6 6 0 0 0 0 0 0 0 0 0 0 0 0 0 0 0 6
6 0 0 0 0 0 0 0 0 0 0 0 0 0 0 6 6 0 0 0 0 0 0 0 0 0 0 0 0 0 0 6
6 0 0 0 0 0 0 0 0 0 0 0 0 0 0 6 6 0 0 0 0 0 0 0 0 0 0 0 0 0 0 6
6 0 0 0 0 0 0 0 0 0 0 0 0 0 0 0 0 0 0 0 0 0 0 0 0 0 0 0 0 0 0 6
6 0 0 0 0 0 0 0 0 0 0 0 0 0 0 0 0 0 0 0 0 0 0 0 0 0 0 0 0 0 0 6
6 6 11 6 11 6 11 6 11 6 11 6 11 6 6 6 6 6 6 6 6 6 6 6 6 6 6 6 6

